111111111111111111111111111111111111111111111111111111111111111111111111111111111111
11111111111111111111111111111111111110010C00000C000011111111111111111111111111111111
111111111111111111111111111111111111100001111100000011111111111111111111111111111111
1111111111111111111111111111111111111P0011100000000011111111111111111111111111111111
111111111111111111111111111111111111111100000000000011111111111111111111111111111111
111111111111111111111111111111111111100000111111010011111111111111111111111111111111
1111111111111111111111111111111111111000000C1000010011111111111111111111111111111111
1111111111111111111111111111111111111111111110001C0011111111111111111111111111111111
11111111111111111111111111111111111110000E000000000011111111111111111111111111111111
111111111111111111111111111111111111111111111111111111111111111111111111111111111111
