111111111
110000001
1P10000E1
11000C001
100000001
111111111