111111111
110000011
1P00001E1
11000C011
100000001
111111111