111111111
110000001
1P00010E1
11001C101
100001001
111111111