11111111
1P000001111
1000C0000E1
11111111111